111111111111111111111111
100C0N0E0110000C00N000C1
10P011010110111110111101
1C1000000110011100000001
111C11100000NC0000111101
100000001101110000111101
101011101101C101100C0001
101N0000N0C0000110110101
1C10111011100C0000N00101
100011100N001110101000C1
11000000111C01000C000001
111111111111111111111111