111111111111111111111111
100C000E0110000C000000C1
10P011010110111110111101
1C1000000110011100000001
111C111000000C0000111101
100000001101110000111101
101011101101C101100C0001
1010000C0000000110110101
1C10111011100C0000000101
1000111000001110101000C1
11000000111C01000C000001
111111111111111111111111